%%%%%%%%%%%%%%%%%%%%%%%%%%%%%%%%%%%%
%↕↔↔↔↔↔↔↔↔↔↔↔↔↔↔↔↔↔↔↔↔↔↔↔↔↔↔↔↔↔↔↔↔P%
%↕%%%%%%%%%%%%%%%%%%%%%%%↕%%%%%%%%↓%
%↕%%↔↔↕%↔↔↕%←←←←←↑%%%%%%%↕↔↔%%←←←←↓%
%↕%%↕%↕%↕%↕%↓%%%%↑%%%%%%%%%↕%%↓%%%%%
%↕%%↕%↕%↕%↕%↓→→  ←←←↑↔↔↔↕%%↕%%↓→→→→%
%↕%%↕%↕%↕%↕%↕%↓%%%%↕↑%%%↔↔↔↕%%%%%%↓%
%↕%↔↕%↕%↕%↔↔↕%↓→→→%%↑%%%%%%%% ←←←←↓%
%↕%%↕%↕%↕%%%%%%%%↓%%←←←←←←←↑%%↓%%%%%
%↕%%↕%↔↔↕%%←←←←←←↓%%%%%%%%%↑%%↓→→→→%
%↔↔↔↕%%%%%%↓%%%%%%%↑→→→→→%%↑%%%%%%↓%
%%%%%%←←←←←↓%↑→→→→→→%%%%↓%%↑% ←←←←↓%
%←←←←←↓%%%%%%↑%%%%%↕%←←←↓%%↑%%↓%%%%%
%↓%%%%%%↑→→→→→%←←←←←←↓%%%%%↑%%↓↑→→→%
%↓→→→→→→→%%%%%%↓%%%%%%%%%%%↑%%↓→%%↓%
%%%%%%%%%%←←←←←↓           ↑%%%%%%↓%
%.←←←←←←←←↓%%%%%%%%%%%%%%%%←←←←←←←↓%
%%%%%%%%%%%%%%%%%%%%%%%%%%%%%%%%%%%%
