%%%%%%%%%%%%%%%%%%%%%%
%↕%%↔↔↔↔↔↔↔↕% %      %
%↔↔↔↕%%%%%%↕% %%%%%% %
%%%%%%←←←←←P  %      %
%↕↔↔↔%↓%%%%%% %% %%%%%
%↕%%%%↓%↑→→→→    %   %
%↔↔↔↔↔↓→→%%%↓%%%   % %
%%%%%%%%%%←←↓ %%%%%% %
%.←←←←←←←←↓%%        %
%%%%%%%%%%%%%%%%%%%%%%
