%%%%%%%%%%%%%%%%%%%%
%4↔↔↔↔↔↕↔↔↔↔↔78%↕↔↔%
%3%%2%%1%%5%%6%%↕%↕%
%↔↔↔↕↔↔↔↔P↔↔↔↔↔↔↔%↕%
%%%%%%%%%%%%%%%%%%↕%
%131211109↔↔↔↔↔↔↔↔↔↔↔↔↕%
%%%%%%%%%%%%%%%%%%%%
