%%%%%%%%%%%%%%%%%%%%%%%%%%%%%%%%%%%%%
%.......% %.%  .......  %...%.....%.%
%.%%%%%%% %.%%%.%.%%%.%%%.%%%%%%%.%.%
%.......%  .....%.%  .  %.....%.%...%
%%%%%.%%%%%.%%%.%.% %.%%%.%%%%%.%.%%%
%...%.%.%.%.  %.%.% %.  %.%...%.%...%
%.%%%.%.%.%.%%%.%%%%%.%%%.%.%%%.%%%.%
%.......%.....%...%  .%.....%.%.%...%
%%%.%%%%%%%%%.%%%%%%%.%%%.%%%.%.%.%.%
%  ...........%.......%.%...%.....%.%
% %.%%%%%.%.%%%.%.%.%%%.%.%%%.%%%.%.%
% %.%.....%.% %.%.%.....%...%.% %.%.%
% %.%.%%%%%%% %.%%%%%%%%%.%%%.% %%%.%
% %.%.%     %  .%.....%.....%.  %  .%
%%%.%%% % %%%%%.%%%%%.%%%.%%%.%%%%%.%
%  .  % % %.....%.%.....%.%...%.%.%.%
% %.% % % %%%.%%%.%%%.%%%.%.%.%.%.%.%
% %.% % %    .............%.%.%.....%
%%%.%%%%%%% % %.%%%%%.%%%.%.%%%.%%%%%
%.....  % % % %.....%...%...  %.%   %
%%%%%.% % %%%%%%%%%.%%%%%%%%%%%.% %%%
%   %.%           %.%.....%...%.%   %
% %%%.%%%%% %%%%%%%%%.%%%%%.%.%.%%% %
% %...%      %........%.....%...    %
% %.%.%%%%% %%%.%.%.%.%.%%%%%%%%%%%%%
% %.%...%     %.%.%.%...    %...%.%.%
% %.%%%.%%% % %.%.%%%%%%%%% %%%.%.%.%
% %...%.%   % %.%...%.%...% %.%.....%
% %%%.%%% %%%%%.%%%.%.%.%%%%%.%.%%%%%
%  ...  %   %  ...%.%.....%...%.%...%
%%%.%.%%%%% %%%%%.%%%.%%%.%.%%%.%.%%%
%.%.%.% % % % %...  %.%...%.%...%.%.%
%.%.%%% % % % %.%%%%%%%%%.%.%.%.%.%.%
%...%   %   %  ...............%.....%
%.%.% % %%% %%% %%%%%%%.%%%.%%% %%%.%
%.%.% %       %   %.......%...% %  P%
%%%%%%%%%%%%%%%%%%%%%%%%%%%%%%%%%%%%%
