%%%%%%%%%%%%%%%%%%%%%%%%%%%%%%%%%%%%%
%↕↔↔↔↔↔↔% %↕%  ←←←←←←↑  %↕↔↔%↔↔↔↔↕%↕%
%↕%%%%%%% %↕%%%↓%↕%%%↑%%%↕%%%%%%%↕%↕%
%↔↔↔↔↕↔↔%  ←←←←↓%↕%  ↑  %↕↔↔↔↔%↕%↕↔↔%
%%%%%↕%%%%%↓%%%↕%↕% %↑%%%↕%%%%%↕%↕%%%
%↕↔↔%↕%↕%↕%↓  %↕%↕% %↑  %↕%↕↔↔%↕%↔↔↕%
%↕%%%↕%↕%↕%↓%%%↕%%%%%↑%%%↕%↕%%%↕%%%↕%
%↔↔↕↔↔↔↔%↔↔↓→→%↕↔↔%  ↑%↔↔↕↔↔%↕%↕%←←↑%
%%%↕%%%%%%%%%↓%%%%%%%↑%%%↕%%%↕%↕%↓%↑%
%  ←←←←←←←←←←↓%↑→→→→→→%↕%↕↔↔%←←←←↓%↑%
% %↓%%%%%↕%↕%%%↑%↕%↕%%%↕%↕%%%↓%%%↕%↑%
% %↓%↔↔↔↔↕%↕% %↑%↕%↕↔↔↔↔%↕↔↔%↓% %↕%↑%
% %↓%↕%%%%%%% %↑%%%%%%%%%↕%%%↓% %%%↑%
% %↓%↕%     %  ↑%↔↔↔↔↕%↔↔↕↔↔%↓  %  ↑%
%%%↓%%% % %%%%%↑%%%%%↕%%%↕%%%↓%%%%%↑%
%  ↓  % % %↔↔↑→→%↕%↔↔↕↔↔%↕%←←↓%↕%↕%↑%
% %↓% % % %%%↑%%%↕%%%↕%%%↕%↓%↕%↕%↕%↑%
% %↓% % %    ←←←←←←←←←←←←↑%↓%↕%↑→→→→%
%%%↓%%%%%%% % %↕%%%%%↕%%%↑%↓%%%↑%%%%%
%↔↔↓→→  % % % %↕↔↔↔↔%↕↔↔%←←↓  %↑%   %
%%%%%↓% % %%%%%%%%%↕%%%%%%%%%%%↑% %%%
%   %↓%           %↕%↕↔↔↔↔%↑→→%↑%   %
% %%%↓%%%%% %%%%%%%%%↕%%%%%↑%↓%↑%%% %
% %←←↓%      %↔↑→→→→→→%↑→→→→%↓→→    %
% %↓%↕%%%%% %%%↑%↕%↕%↓%↑%%%%%%%%%%%%%
% %↓%↕↔↔%     %↑%↕%↕%↓→→    %↔↔↕%↕%↕%
% %↓%%%↕%%% % %↑%↕%%%%%%%%% %%%↕%↕%↕%
% %↓→→%↕%   % %↑%↕↔↔%↕%↕↔↔% %↕%↕↔↔↔↔%
% %%%↓%%% %%%%%↑%%%↕%↕%↕%%%%%↕%↕%%%%%
%  ←←↓  %   %  ←←↑%↕%↔↔↔↔↕%↕↔↔%↕%↕↔↔%
%%%↓%↕%%%%% %%%%%↑%%%↕%%%↕%↕%%%↕%↕%%%
%↕%↓%↕% % % % %↑→→  %↕%↔↔↕%↕%←←↑%↕%↕%
%↕%↓%%% % % % %↑%%%%%%%%%↕%↕%↓%↑%↕%↕%
%←←↓%   %   %  ←←←←←←←←←←←←←←↓%←←←←↑%
%↓%↕% % %%% %%% %%%%%%%↕%%%↕%%% %%%↑%
%.%↕% %       %   %↔↔↔↔↕↔↔%↕↔↔% %↔↔P%
%%%%%%%%%%%%%%%%%%%%%%%%%%%%%%%%%%%%%
