%%%%%%%%%%%%%%%%%%%%%%%%%%%%%%%%%%%%
%.................................P%
%.%%%%%%%%%%%%%%%%%%%%%%%.%%%%%%%%.%
%.%%...%...%......%%%%%%%...%%.....%
%.%%.%.%.%.%.%%%%.%%%%%%%%%.%%.%%%%%
%.%%.%.%.%.%...  ........%%.%%.....%
%.%%.%.%.%.%.%.%%%%..%%%....%%%%%%.%
%.%..%.%.%...%....%%.%%%%%%%% .....%
%.%%.%.%.%%%%%%%%.%%........%%.%%%%%
%.%%.%...%%.......%%%%%%%%%.%%.....%
%....%%%%%%.%%%%%%%......%%.%%%%%%.%
%%%%%%......%.......%%%%.%%.% .....%
%......%%%%%%.%%%%%.%....%%.%%.%%%%%
%.%%%%%%......%.......%%%%%.%%.....%
%........%%%%%%.%%%%%%%%%%%.%%..%%.%
%%%%%%%%%%......           .%%%%%%.%
%..........%%%%%%%%%%%%%%%%........%
%%%%%%%%%%%%%%%%%%%%%%%%%%%%%%%%%%%%
