%%%%%%%%%%%%%%%%%%%%%%%%%%%%%%%%%%%%%
%↔↔↔↔↔↔↔↔↔↔↔↔↔↕←↑←↑←↑←↑←↑←↑←↑←↑←↑←↑P%
%↔↔↔↔↔↔↔↔↔↔↔↕%↕↓↑↓↑↓↑↓↑↓↑↓↑↓↑↓↑↓↑↓↑↓%
%↔↔↔↔↔↔↔↔↔↔↔↕%↕↓↑↓↑↓↑↓↑↓↑↓↑↓↑↓↑↓↑↓↑↓%
%↔↔↔↔↔↔↔↔↔↔↔↕%↕↓↑↓↑↓↑↓↑↓↑↓↑↓↑↓↑↓↑↓↑↓%
%↔↔↔↔↔↔↔↔↔↔↔↕%↕↓↑↓↑↓↑↓↑↓↑↓↑↓↑↓↑↓↑↓↑↓%
%↔↔↔↔↔↔↔↔↔↔↔↕%↕↓↑↓↑↓←↓↑↓↑↓↑↓↑↓↑↓↑↓↑↓%
%↔↔↔↔↔↔↔↔↔↔↔↕%↕↓↑↓↑↓%↕↑↓↑↓↑↓↑↓↑↓↑↓↑↓%
%↔↔↔↔↔↔↔↔↔↔↔↕%↕↓↑↓↑↓%↕↑↓↑↓↑↓↑↓↑↓↑↓↑↓%
%↔↔↔↔↔↔↔↔↔↔↔↕%↕↓↑↓↑↓%↕↑↓↑↓↑↓↑↓↑↓↑↓↑↓%
%↔↔↔↔↔↔↔↔↔↔↔↕%↕↓↑↓↑↓%↕↑↓↑↓↑↓↑↓↑↓↑↓↑↓%
%↔↔↔↔↔↔↔↔↔↔↔↕%↕↓↑↓↑↓%↕↑↓↑↓↑↓↑↓↑↓↑↓↑↓%
%↔↔↔↔↔↔↔↔↔↔↔↕%↕↓↑↓↑↓%↕↑↓↑↓↑↓↑↓↑↓↑↓↑↓%
%↔↔↔↔↔↔↔↔↔↔↔↕%↕↓↑↓↑↓%↕←↓←↓←↓←↓←↓←↓←↓%
%%%%%%%%%%%%%%↕↓↑↓↑↓%%%%%%%%%%%%%%%%%
%←↑←↑←↑←↑←↑←↑%↕↓↑↓↑↓                %
%↓↑↓↑↓↑↓↑↓↑↓↑%↕↓↑↓↑↓                %
%↓↑↓↑↓↑↓↑↓↑↓↑%↕↓↑↓↑↓                %
%↓↑↓↑↓↑↓↑↓↑↓↑←↑↓↑↓↑↓                %
%↓↑↓↑↓↑↓↑↓↑↓↑↓↑↓↑↓↑↓                %
%↓↑↓↑↓↑↓↑↓↑↓↑↓↑↓↑↓↑↓                %
%.←↓←↓←↓←↓←↓←↓←↓←↓←↓                %
%%%%%%%%%%%%%%%%%%%%%%%%%%%%%%%%%%%%%
