%%%%%%%%%%%%%%%%%%%%%%
%.%%........% %      %
%....%%%%%%.% %%%%%% %
%%%%%%.....P  %      %
%....%.%%%%%% %% %%%%%
%.%%%%.%.....    %   %
%........%%%.%%%   % %
%%%%%%%%%%... %%%%%% %
%..........%%        %
%%%%%%%%%%%%%%%%%%%%%%
