%%%%%%%%%%%%%%%%%%%%
%10↔↔↔↔↔↕↔↔↔↔↔21314P↔15%
%11%%9%%8%%3%%1%%↕%16%
%↕%%↕%127654↔↔↔↔↔↕%17%
%%%%%%%%%%%%%%%%%%%%
