%%%%%%%%%%%%%%%%%%%%
%.↔↔↔↔↔↕↔↔↔↔↔...P↔.%
%.%%.%%.%%.%%.%%↕%.%
%↕%%↕%.....↔↔↔↔↔↕%.%
%%%%%%%%%%%%%%%%%%%%
