%%%%%%%%%%%%%%%%%%%%%%
%↕%%↔↔↔↔↔↔↔↕%↕%↔↔↔↔↔↕%
%↔↔↔↕%%%%%%↕%↕%%%%%%↕%
%%%%%%←←←←←P↔↔%↔↕↔↔↔↔%
%↕↔↔↔%↓%%%%%%↕%%↕%%%%%
%↕%%%%↓%↑→→→→↕↔↔↔%↕↔↔%
%↔↔↔↔↔↓→→%%%↓%%%↕↔↔%↕%
%%%%%%%%%%←←↓↕%%%%%%↕%
%.←←←←←←←←↓%%↔↔↔↔↔↔↔↕%
%%%%%%%%%%%%%%%%%%%%%%
