%%%%%%%%%
%32↔↕↔45%
%%%%1%%↕%
%↔↔↔P↔↔↕%
%9%%↕%%6%
%10%8↔↔↔7%
%%%%%%%%%
