%%%%%%%%%
%..↔↕↔..%
%%%%.%%↕%
%↔↔↔P↔↔↕%
%.%%↕%%.%
%.%.↔↔↔.%
%%%%%%%%%
