%%%%%%%%%%%%%%%%%%%%
%.↔↔↔↔↔↕↔↔↔↔↔..%↕↔↔%
%.%%.%%.%%.%%.%%↕%↕%
%↔↔↔↕↔↔↔↔P↔↔↔↔↔↔↔%↕%
%%%%%%%%%%%%%%%%%%↕%
%.....↔↔↔↔↔↔↔↔↔↔↔↔↕%
%%%%%%%%%%%%%%%%%%%%
